JDataWrapper	KEYWORD1

getJData	KEYWORD2


JTrasmissionMethod	KEYWORD1

receive	KEYWORD2
send	KEYWORD2


JData	KEYWORD1

LONG	LITERAL1
DOUBLE	LITERAL1
BOOLEAN	LITERAL1
STRING	LITERAL1
JDATA	LITERAL1

addLong	KEYWORD2
addDouble	KEYWORD2
addBoolean	KEYWORD2
addString	KEYWORD2
addJData	KEYWORD2
getLong	KEYWORD2
getDouble	KEYWORD2
getDoubleString	KEYWORD2
getString	KEYWORD2
getJData	KEYWORD2
getKey	KEYWORD2
getType	KEYWORD2
length	KEYWORD2
containsKey	KEYWORD2


Jack	KEYWORD1

start	KEYWORD2
stop	KEYWORD2
send	KEYWORD2
flushBufferSend	KEYWORD2
loop	KEYWORD2